RB-1	B=POÇO
RUC-1	B=POÇO
poço CM-2	B=POÇO
idade pós- Campaniano	B=UNIDADE_CRONO
cimento poiquilotópico	B=TEXTURA
rocha de falha	B=ROCHA
litofácies vulcanoclásticas	B=ROCHA
intrusão ígnea	B=ROCHA
intrusões ígneas	B=ROCHA
gouge de falha	B=ROCHA
corpo ígneo	B=ROCHA
corpos ígneos	B=ROCHA
geração	B=EVENTO_PETRO
CPB-1R-SE	B=POÇO	
ES-2	B=POÇO
ES-3	B=POÇO
2-AM-2-AM	B=POÇO
2-PE-2-AM	B=POÇO
2-PUST-1-SC	B=POÇO
Jequiá	B=UNIDADE_CRONO
Bashkiriano	B=UNIDADE_CRONO
Tatuí	B=UNIDADE_LITO
Burgan	B=UNIDADE_LITO
Iabe	B=UNIDADE_LITO
M’ Vone	B=UNIDADE_LITO
N’Dombo	B=UNIDADE_LITO
vulcanoclastos	B=NÃOCONSOLID
partículas vulcânicas	B=NÃOCONSOLID
material vulcanoclástico	B=NÃOCONSOLID
material vulcânico	B=NÃOCONSOLID
lavas vulcânicas	B=NÃOCONSOLID
fragmentos vulcânicos	B=NÃOCONSOLID
grãos de origem	B=NÃOCONSOLID
grãos neovulcânicos	B=NÃOCONSOLID
grãos paleovulcânicos	B=NÃOCONSOLID
Formação Rio do Sul	B=UNIDADE_LITO